11111111111111111111111111111111
1..............................1
1..............................1
1..............................1
1..............................1
1..............................1
1..............................1
E..............................G
E..............................G
E..............................G
E..............................G
E..............................G
E.......P.....B........M.......G
E..............................G
E..............................G
E..............................G
1..............................1
1..............................1
1..............................1
1..............................1
1..............................1
1..............................1
1..............................1
11111111111111111111111111111111